S R H D D R R D D D 
D R H R D D R R G D 
G R H R G D D R R D 
D R D R D R D G D D 
D D D D D R R R H H 
H R D R G D D R H H 
H R D R R R R R R D 
H R D D D D D R D D 
D R R R R R D R D R 
D D G D D R D R E D 